{

  "city": [

    { "MAPA_ARCADE": "01",
      "blockers": 90,
      "grid": [
        [3,0,0,0,0,0,0,1,0,0,0,0,0,0,3],
        [0,6,9,0,6,9,0,0,0,6,9,0,6,9,0],
        [0,9,9,0,9,9,1,0,1,9,9,0,9,9,0],
        [0,0,0,0,0,0,1,0,1,0,0,0,0,0,0],
        [6,9,0,10,9,0,0,0,0,0,10,9,0,6,9],
        [9,9,0,0,0,0,2,2,2,0,0,0,0,9,9],
        [0,0,0,1,1,0,2,2,2,0,1,1,0,0,0],
        [6,9,0,0,0,0,2,2,2,0,0,0,0,6,9],
        [9,9,0,10,9,0,0,0,0,0,10,9,0,9,9],
        [0,0,0,0,0,0,1,0,1,0,0,0,0,0,0],
        [0,6,9,0,6,9,1,0,1,6,9,0,6,9,0],
        [0,9,9,0,9,9,0,0,0,9,9,0,9,9,0],
        [3,0,0,0,0,0,0,1,0,0,0,0,0,0,3]
      ]
    },
    { "MAPA_ARCADE": "02",
      "blockers": 90,
      "grid": [
        [3,0,0,0,6,9,0,0,0,6,9,0,0,0,3],
        [0,1,1,0,9,9,0,1,0,9,9,0,1,1,0],
        [0,1,0,0,0,0,0,1,0,0,0,0,0,1,0],
        [0,0,0,6,9,0,1,1,1,0,6,9,0,0,0],
        [0,1,0,9,9,0,0,0,0,0,9,9,0,1,0],
        [0,1,0,0,0,0,2,2,2,0,0,0,0,1,0],
        [0,1,10,9,1,0,2,2,2,0,1,10,9,1,0],
        [0,1,0,0,0,0,2,2,2,0,0,0,0,1,0],
        [0,1,0,6,9,0,0,0,0,0,6,9,0,1,0],
        [0,0,0,9,9,0,1,1,1,0,9,9,0,0,0],
        [0,1,0,0,0,0,0,1,0,0,0,0,0,1,0],
        [0,1,1,0,6,9,0,1,0,6,9,0,1,1,0],
        [3,0,0,0,9,9,0,0,0,9,9,0,0,0,3]
      ]
    },
    { "MAPA_ARCADE": "03",
      "blockers": 90,
      "grid": [
        [3,0,0,0,0,6,9,0,6,9,0,0,0,0,3],
        [0,6,9,1,0,9,9,0,9,9,0,1,6,9,0],
        [0,9,9,0,0,0,0,0,0,0,0,0,9,9,0],
        [0,0,0,0,1,1,1,0,1,1,1,0,0,0,0],
        [0,6,9,0,1,0,0,0,0,0,1,0,6,9,0],
        [0,9,9,0,1,0,2,2,2,0,1,0,9,9,0],
        [0,0,0,0,0,0,2,2,2,0,0,0,0,0,0],
        [0,6,9,0,1,0,2,2,2,0,1,0,6,9,0],
        [0,9,9,0,1,0,0,0,0,0,1,0,9,9,0],
        [0,0,0,0,1,1,1,0,1,1,1,0,0,0,0],
        [0,6,9,0,0,0,0,0,0,0,0,0,6,9,0],
        [0,9,9,1,0,6,9,0,6,9,0,1,9,9,0],
        [3,0,0,0,0,9,9,0,9,9,0,0,0,0,3]
      ]
    }
  ],

  "aqua_park": [

    { "MAPA_ARCADE": "01",
      "blockers": 90,
      "grid": [
        [3,0,0,0,0,0,0,0,0,0,0,0,0,0,3],
        [0,1,7,1,1,1,1,7,1,1,1,1,7,1,0],
        [0,1,7,5,5,5,5,7,5,5,5,5,7,1,0],
        [0,1,7,1,1,1,1,7,1,1,1,1,7,1,0],
        [0,7,7,7,0,0,0,0,0,0,0,7,7,7,0],
        [0,1,5,1,1,0,2,2,2,0,1,1,5,1,0],
        [4,1,5,1,0,0,2,2,2,0,0,1,5,1,4],
        [0,1,5,1,1,0,2,2,2,0,1,1,5,1,0],
        [0,7,7,7,0,0,0,0,0,0,0,7,7,7,0],
        [0,1,7,1,1,1,1,7,1,1,1,1,7,1,0],
        [0,1,7,5,5,5,5,7,5,5,5,5,7,1,0],
        [0,1,7,1,1,1,1,7,1,1,1,1,7,1,0],
        [3,0,0,0,0,0,0,0,0,0,0,0,0,0,3]
      ]
    },
    { "MAPA_ARCADE": "02",
      "blockers": 90,
      "grid": [
        [3,0,0,0,1,0,0,0,0,0,1,0,0,0,3],
        [0,1,1,0,1,7,1,1,1,7,1,0,1,1,0],
        [0,1,5,5,5,7,7,1,7,7,5,5,5,1,0],
        [0,1,5,1,1,1,0,1,0,1,1,1,5,1,0],
        [7,7,5,0,1,0,0,0,0,0,1,0,5,7,7],
        [1,7,1,0,1,0,2,2,2,0,1,0,1,7,1],
        [4,0,0,0,0,0,2,2,2,0,0,0,0,0,4],
        [1,7,1,0,1,0,2,2,2,0,1,0,1,7,1],
        [7,7,5,0,1,0,0,0,0,0,1,0,5,7,7],
        [0,1,5,1,1,1,0,1,0,1,1,1,5,1,0],
        [0,1,5,5,5,7,7,1,7,7,5,5,5,1,0],
        [0,1,1,0,1,7,1,1,1,7,1,0,1,1,0],
        [3,0,0,0,1,0,0,0,0,0,1,0,0,0,3]
      ]
    },
	{ "MAPA_ARCADE": "03",
      "blockers": 90,
      "grid": [
        [3,0,0,0,0,0,0,4,0,0,0,0,0,0,3],
        [0,1,1,1,0,1,1,1,1,1,0,1,1,1,0],
        [0,0,7,7,7,5,5,5,5,5,7,7,7,0,0],
        [0,1,1,5,1,1,1,7,1,1,1,5,1,1,0],
        [0,0,1,5,1,0,0,0,0,0,1,5,1,0,0],
        [0,1,1,5,1,0,2,2,2,0,1,5,1,1,0],
        [0,0,7,7,7,0,2,2,2,0,7,7,7,0,0],
        [0,1,1,5,1,0,2,2,2,0,1,5,1,1,0],
        [0,0,1,5,1,0,0,0,0,0,1,5,1,0,0],
        [0,1,1,5,1,1,1,7,1,1,1,5,1,1,0],
        [0,0,7,7,7,5,5,5,5,5,7,7,7,0,0],
        [0,1,1,1,0,1,1,1,1,1,0,1,1,1,0],
        [3,0,0,0,0,0,0,4,0,0,0,0,0,0,3]
      ]
    }
  ],

  "farm": [

    { "MAPA_ARCADE": "01",
      "blockers": 90,
      "tractor_route": [[3,2], [11,2], [11,10], [3,10]],
      "grid": [
        [3,0,0,0,1,0,0,0,0,0,1,0,0,0,3],
        [0,1,0,1,1,1,1,0,1,1,1,1,0,1,0],
        [0,1,0,5,5,5,5,5,5,5,5,5,0,1,0],
        [0,1,1,5,1,1,6,0,6,1,1,5,1,1,0],
        [0,0,0,5,1,0,0,0,0,0,1,5,0,0,0],
        [0,1,1,5,6,0,2,2,2,0,6,5,1,1,0],
        [6,6,0,5,0,0,2,2,2,0,0,5,0,6,6],
        [0,1,1,5,6,0,2,2,2,0,6,5,1,1,0],
        [0,0,0,5,1,0,0,0,0,0,1,5,0,0,0],
        [0,1,1,5,1,1,6,0,6,1,1,5,1,1,0],
        [0,1,0,5,5,5,5,5,5,5,5,5,0,1,0],
        [0,1,0,1,1,1,1,0,1,1,1,1,0,1,0],
        [3,0,0,0,1,0,0,0,0,0,1,0,0,0,3]
      ]
    },
    { "MAPA_ARCADE": "02",
      "blockers": 90,
      "tractor_route": [[6,1],[8,1],[8,3],[10,3],[10,5],[12,5],[12,7],[10,7],[10,9],[8,9],[8,11],[6,11],[6,9],[4,9],[4,7],[2,7],[2,5],[4,5],[4,3],[6,3]],
      "grid": [
        [3,0,0,0,0,0,1,1,1,0,0,0,0,0,3],
        [0,1,1,1,1,0,5,5,5,0,1,1,1,1,0],
        [0,0,0,0,0,6,5,1,5,6,0,0,0,0,0],
        [0,1,1,1,5,5,5,1,5,5,5,1,1,1,0],
        [0,0,0,1,5,6,0,0,0,6,5,1,0,0,0],
        [0,6,5,5,5,0,2,2,2,0,5,5,5,6,0],
        [1,1,5,1,1,0,2,2,2,0,1,1,5,1,1],
        [0,6,5,5,5,0,2,2,2,0,5,5,5,6,0],
        [0,0,0,1,5,6,0,0,0,6,5,1,0,0,0],
        [0,1,1,1,5,5,5,1,5,5,5,1,1,1,0],
        [0,0,0,0,0,6,5,1,5,6,0,0,0,0,0],
        [0,1,1,1,1,0,5,5,5,0,1,1,1,1,0],
        [3,0,0,0,0,0,1,1,1,0,0,0,0,0,3]
      ]
    },
	{ "MAPA_ARCADE": "03",
      "blockers": 90,
      "tractor_route": [[6,0],[8,0],[8,2],[9,2],[9,4],[11,4],[11,8],[9,8],[9,10],[8,10],[8,12],[6,12],[6,10],[5,10],[5,8],[3,8],[3,4],[5,4],[5,2],[6,2]],
      "grid": [
        [3,0,0,0,1,1,5,5,5,1,1,0,0,0,3],
        [0,1,1,0,0,1,5,1,5,1,0,0,1,1,0],
        [0,0,1,1,0,5,5,1,5,5,0,1,1,0,0],
        [1,0,0,1,1,5,6,1,6,5,1,1,0,0,1],
        [1,1,0,5,5,5,0,0,0,5,5,5,0,1,1],
        [0,1,1,5,6,0,2,2,2,0,6,5,1,1,0],
        [0,0,0,5,0,0,2,2,2,0,0,5,0,0,0],
        [0,1,1,5,6,0,2,2,2,0,6,5,1,1,0],
        [1,1,0,5,5,5,0,0,0,5,5,5,0,1,1],
        [1,0,0,1,1,5,6,1,6,5,1,1,0,0,1],
        [0,0,1,1,0,5,5,1,5,5,0,1,1,0,0],
        [0,1,1,0,0,1,5,1,5,1,0,0,1,1,0],
        [3,0,0,0,1,1,5,5,5,1,1,0,0,0,3]
      ]
    }
  ],

  "shopping_mall": [

    { "MAPA_ARCADE": "01",
      "blockers": 90,
      "grid": [
        [3,0,0,1,0,6,0,0,0,6,0,1,0,0,3],
        [0,1,0,0,0,6,0,6,0,6,0,0,0,1,0],
        [0,1,1,0,1,6,0,0,0,6,1,0,1,1,0],
        [0,0,1,0,0,6,7,6,7,6,0,0,1,0,0],
        [0,1,1,1,0,0,4,6,4,0,0,1,1,1,0],
        [0,4,7,0,0,6,2,2,2,6,0,0,7,4,0],
        [6,0,6,6,6,6,2,2,2,6,6,6,6,0,6],
        [0,4,7,0,0,6,2,2,2,6,0,0,7,4,0],
        [0,1,1,1,0,0,4,6,4,0,0,1,1,1,0],
        [0,0,1,0,0,6,7,6,7,6,0,0,1,0,0],
        [0,1,1,0,1,6,0,0,0,6,1,0,1,1,0],
        [0,1,0,0,0,6,0,6,0,6,0,0,0,1,0],
        [3,0,0,1,0,6,0,0,0,6,0,1,0,0,3]
      ]
    },
    { "MAPA_ARCADE": "02",
      "blockers": 90,
      "grid": [
        [3,0,0,0,0,7,4,6,4,7,0,0,0,0,3],
        [0,1,1,1,0,1,0,6,0,1,0,1,1,1,0],
        [0,1,0,0,0,1,0,0,0,1,0,0,0,1,0],
        [0,1,0,1,1,1,7,6,7,1,1,1,0,1,0],
        [4,7,0,0,1,0,4,6,4,0,1,0,0,7,4],
        [1,0,1,0,0,0,2,2,2,0,0,0,1,0,1],
        [6,0,6,6,0,6,2,2,2,6,0,6,6,0,6],
        [1,0,1,0,0,0,2,2,2,0,0,0,1,0,1],
        [4,7,0,0,1,0,4,6,4,0,1,0,0,7,4],
        [0,1,0,1,1,1,7,6,7,1,1,1,0,1,0],
        [0,1,0,0,0,1,0,0,0,1,0,0,0,1,0],
        [0,1,1,1,0,1,0,6,0,1,0,1,1,1,0],
        [3,0,0,0,0,7,4,6,4,7,0,0,0,0,3]
      ]
    },
	{ "MAPA_ARCADE": "03",
      "blockers": 90,
      "grid": [
        [3,0,0,0,0,0,6,0,6,0,0,0,0,0,3],
        [0,1,0,1,1,0,0,4,0,0,1,1,0,1,0],
        [0,1,0,0,0,0,6,7,6,0,0,0,0,1,0],
        [0,1,1,0,6,6,6,0,6,6,6,0,1,1,0],
        [0,0,0,0,6,0,0,4,7,0,6,0,0,0,0],
        [6,6,0,6,6,7,2,2,2,0,6,6,0,6,6],
        [0,0,4,7,0,4,2,2,2,4,0,7,4,0,0],
        [6,6,0,6,6,0,2,2,2,7,6,6,0,6,6],
        [0,0,0,0,6,0,7,4,0,0,6,0,0,0,0],
        [0,1,1,0,6,6,6,0,6,6,6,0,1,1,0],
        [0,1,0,0,0,0,6,7,6,0,0,0,0,1,0],
        [0,1,0,1,1,0,0,4,0,0,1,1,0,1,0],
        [3,0,0,0,0,0,6,0,6,0,0,0,0,0,3]
      ]
    }
  ]

}