{

  "aqua_park": [

    { "MAPA_ARCADE": "01",
      "blockers": 90,
      "initial_position_sheep_1": {"x":5, "y":4},
      "initial_position_sheep_2": {"x":9, "y":4},
      "initial_position_sheep_3": {"x":5, "y":8},
      "initial_position_sheep_4": {"x":9, "y":8},
      "sheeps": 4,
      "grid": [
        [3,0,0,0,0,0,0,0,0,0,0,0,0,0,3],
        [0,1,0,1,1,0,1,1,1,1,1,0,8,1,0],
        [0,1,0,8,0,0,0,0,0,0,0,0,0,1,0],
        [0,1,0,1,0,1,1,1,0,1,8,1,0,1,0],
        [0,1,0,1,0,0,0,0,0,0,0,1,0,1,0],
        [0,1,0,1,0,0,2,2,2,0,0,1,0,1,0],
        [0,1,0,0,0,0,2,2,2,0,0,1,0,0,0],
        [0,0,0,1,0,0,2,2,2,0,0,0,0,1,0],
        [0,1,0,1,0,0,0,0,0,0,0,8,0,1,0],
        [0,1,0,1,8,1,1,0,1,1,1,1,0,1,0],
        [0,1,0,0,0,0,0,0,0,0,0,0,0,8,0],
        [0,1,8,1,0,1,1,1,1,1,1,0,1,1,0],
        [3,0,0,0,0,0,0,0,0,0,0,0,0,0,3]
      ]
    },
    { "MAPA_ARCADE": "02",
      "blockers": 90,
      "initial_position_sheep_1": {"x":5, "y":4},
      "initial_position_sheep_2": {"x":9, "y":4},
      "initial_position_sheep_3": {"x":5, "y":8},
      "initial_position_sheep_4": {"x":9, "y":8},
      "sheeps": 4,
      "grid": [
        [3,0,0,0,0,0,0,0,0,0,0,0,0,0,3],
        [0,1,1,0,1,1,1,0,1,1,0,1,1,1,0],
        [0,0,0,0,0,0,8,0,8,0,0,0,0,0,0],
        [0,1,1,1,0,1,1,0,1,1,1,1,0,1,0],
        [0,8,0,0,0,0,0,0,0,0,0,0,0,8,0],
        [0,1,0,1,1,0,2,2,2,0,1,0,1,1,0],
        [0,0,0,0,8,0,2,2,2,0,8,0,0,0,0],
        [0,1,1,0,1,0,2,2,2,0,1,1,0,1,0],
        [0,8,0,0,0,0,0,0,0,0,0,0,0,8,0],
        [0,1,1,1,0,1,1,0,1,1,1,0,1,1,0],
        [0,0,0,0,0,0,8,0,8,0,0,0,0,0,0],
        [0,1,1,0,1,1,1,0,1,1,0,1,1,1,0],
        [3,0,0,0,0,0,0,0,0,0,0,0,0,0,3]
      ]
    },
	{ "MAPA_ARCADE": "03",
      "blockers": 90,
      "initial_position_sheep_1": {"x":3, "y":4},
      "initial_position_sheep_2": {"x":10, "y":3},
      "initial_position_sheep_3": {"x":4, "y":9},
      "initial_position_sheep_4": {"x":11, "y":8},
      "sheeps": 4,
      "grid": [
        [3,0,0,0,0,0,0,0,0,0,0,0,0,0,3],
        [0,1,0,5,5,5,5,5,5,5,5,5,8,1,0],
        [0,8,0,0,0,0,0,0,0,0,0,0,0,0,0],
        [0,5,0,1,8,5,5,5,5,5,0,1,0,5,0],
        [0,5,0,0,0,0,0,0,0,0,0,8,0,5,0],
        [0,5,0,5,0,1,2,2,2,1,0,5,0,5,0],
        [0,5,0,5,0,4,2,2,2,4,0,5,0,5,0],
        [0,5,0,5,0,1,2,2,2,1,0,5,0,5,0],
        [0,5,0,8,0,0,0,0,0,0,0,0,0,5,0],
        [0,5,0,1,0,5,5,5,5,5,8,1,0,5,0],
        [0,0,0,0,0,0,0,0,0,0,0,0,0,8,0],
        [0,1,8,5,5,5,5,5,5,5,5,5,0,1,0],
        [3,0,0,0,0,0,0,0,0,0,0,0,0,0,3]
      ]
    },
    {
      "MAPA_ARCADE": "04",
      "blockers": 90,
      "initial_position_sheep_1": {"x":3, "y":2},
      "initial_position_sheep_2": {"x":11, "y":2},
      "initial_position_sheep_3": {"x":4, "y":10},
      "initial_position_sheep_4": {"x":11, "y":10},
      "sheeps": 4,
      "grid": [
        [3,0,0,0,0,0,0,0,0,0,0,0,0,0,3],
        [0,8,0,5,5,5,5,0,5,5,5,5,5,8,0],
        [0,5,0,0,0,0,5,0,5,0,0,0,0,0,0],
        [0,5,4,0,8,5,5,0,5,0,8,0,1,5,0],
        [0,5,0,0,0,0,0,0,0,0,5,0,0,5,0],
        [0,5,5,5,5,0,2,2,2,0,5,5,5,5,0],
        [0,0,0,0,0,0,2,2,2,0,0,0,0,0,0],
        [0,5,5,5,5,0,2,2,2,0,5,5,5,5,0],
        [0,5,0,0,5,0,0,0,0,0,0,0,0,5,0],
        [0,5,1,0,8,0,5,0,5,5,8,0,4,5,0],
        [0,0,0,0,0,0,5,0,5,0,0,0,0,5,0],
        [0,8,5,5,5,5,5,0,5,5,5,5,0,8,0],
        [3,0,0,0,0,0,0,0,0,0,0,0,0,0,3]
      ]
    }
  ],

  "city": [

    { "MAPA_ARCADE": "01",
      "blockers": 90,
      "initial_position_sheep_1": {"x":5, "y":5},
      "initial_position_sheep_2": {"x":9, "y":5},
      "initial_position_sheep_3": {"x":5, "y":7},
      "initial_position_sheep_4": {"x":9, "y":7},
      "sheeps": 4,
      "grid": [
        [3,0,0,0,0,0,0,0,0,0,0,0,0,0,3],
        [0,6,9,0,8,8,8,0,8,8,8,0,6,9,0],
        [0,9,9,0,8,0,0,0,0,0,8,0,9,9,0],
        [0,0,0,0,8,0,10,9,1,0,8,0,0,0,0],
        [0,8,8,8,8,0,0,0,0,0,8,8,8,8,0],
        [0,8,0,0,0,0,2,2,2,0,0,0,0,8,0],
        [0,0,0,10,9,0,2,2,2,0,10,9,0,0,0],
        [0,8,0,0,0,0,2,2,2,0,0,0,0,8,0],
        [0,8,8,8,8,0,0,0,0,0,8,8,8,8,0],
        [0,0,0,0,8,0,1,10,9,0,8,0,0,0,0],
        [0,6,9,0,8,0,0,0,0,0,8,0,6,9,0],
        [0,9,9,0,8,8,8,0,8,8,8,0,9,9,0],
        [3,0,0,0,0,0,0,0,0,0,0,0,0,0,3]
      ]
    },
    { "MAPA_ARCADE": "02",
      "blockers": 90,
      "initial_position_sheep_1": {"x":5, "y":3},
      "initial_position_sheep_2": {"x":9, "y":3},
      "initial_position_sheep_3": {"x":5, "y":9},
      "initial_position_sheep_4": {"x":9, "y":9},
      "sheeps": 4,
      "grid": [
        [3,0,0,0,8,0,0,0,0,0,8,0,0,0,3],
        [0,6,9,0,8,6,9,0,6,9,8,0,6,9,0],
        [0,9,9,0,8,9,9,0,9,9,8,0,9,9,0],
        [0,0,0,0,0,0,8,0,8,0,0,0,0,0,0],
        [6,9,0,6,9,0,0,0,0,0,6,9,0,6,9],
        [9,9,0,9,9,0,2,2,2,0,9,9,0,9,9],
        [0,0,0,0,0,0,2,2,2,0,0,0,0,0,0],
        [6,9,0,6,9,0,2,2,2,0,6,9,0,6,9],
        [9,9,0,9,9,0,0,0,0,0,9,9,0,9,9],
        [0,0,0,0,0,0,8,0,8,0,0,0,0,0,0],
        [0,6,9,0,8,6,9,0,6,9,8,0,6,9,0],
        [0,9,9,0,8,9,9,0,9,9,8,0,9,9,0],
        [3,0,0,0,8,0,0,0,0,0,8,0,0,0,3]
      ]
    },
	{ "MAPA_ARCADE": "03",
      "blockers": 90,
      "initial_position_sheep_1": {"x":4, "y":3},
      "initial_position_sheep_2": {"x":10, "y":3},
      "initial_position_sheep_3": {"x":4, "y":9},
      "initial_position_sheep_4": {"x":10, "y":9},
      "sheeps": 4,
      "grid": [
        [3,0,0,8,6,9,8,0,8,6,9,8,0,0,3],
        [0,8,0,8,9,9,8,0,8,9,9,8,0,8,0],
        [0,8,0,8,8,8,8,0,8,8,8,8,0,8,0],
        [0,0,0,0,0,0,0,0,0,0,0,0,0,0,0],
        [8,8,8,8,0,8,8,0,8,8,0,8,8,8,8],
        [10,9,8,0,0,8,2,2,2,8,0,0,8,10,9],
        [8,8,8,0,8,8,2,2,2,8,8,0,8,8,8],
        [10,9,8,0,0,8,2,2,2,8,0,0,8,10,9],
        [8,8,8,8,0,8,8,0,8,8,0,8,8,8,8],
        [0,0,0,0,0,0,0,0,0,0,0,0,0,0,0],
        [0,8,0,8,8,8,8,0,8,8,8,8,0,8,0],
        [0,8,0,8,6,9,8,0,8,6,9,8,0,8,0],
        [3,0,0,8,9,9,8,0,8,9,9,8,0,0,3]
      ]
    }
  ],

  "shopping_mall": [

    { "MAPA_ARCADE": "01",
      "blockers": 90,
      "initial_position_sheep_1": {"x":8, "y":2},
      "initial_position_sheep_2": {"x":3, "y":5},
      "initial_position_sheep_3": {"x":11, "y":7},
      "initial_position_sheep_4": {"x":6, "y":10},
      "sheeps": 4,
      "grid": [
        [3,0,0,0,0,0,0,0,8,0,0,0,0,0,3],
        [0,1,1,1,1,0,1,0,8,0,1,1,1,1,0],
        [0,0,0,0,0,0,1,0,0,0,0,0,0,0,0],
        [0,1,1,1,1,0,1,0,8,0,1,1,0,1,0],
        [0,0,0,0,0,0,0,0,8,0,0,0,0,1,0],
        [8,8,8,0,8,8,2,2,2,0,1,1,0,1,0],
        [0,0,0,0,0,0,2,2,2,0,0,0,0,0,0],
        [0,1,0,1,1,0,2,2,2,8,8,0,8,8,8],
        [0,1,0,0,0,0,8,0,0,0,0,0,0,0,0],
        [0,1,0,1,1,0,8,0,1,0,1,1,1,1,0],
        [0,0,0,0,0,0,0,0,1,0,0,0,0,0,0],
        [0,1,1,1,1,0,8,0,1,0,1,1,1,1,0],
        [3,0,0,0,0,0,8,0,0,0,0,0,0,0,3]
      ]
    },
    { "MAPA_ARCADE": "02",
      "blockers": 90,
      "initial_position_sheep_1": {"x":5, "y":4},
      "initial_position_sheep_2": {"x":9, "y":4},
      "initial_position_sheep_3": {"x":5, "y":8},
      "initial_position_sheep_4": {"x":9, "y":8},
      "sheeps": 4,
      "grid": [
        [3,0,0,0,0,0,0,8,0,0,0,0,0,0,3],
        [0,8,8,8,0,8,0,8,0,8,0,8,8,8,0],
        [0,8,0,0,0,8,0,0,0,8,0,0,0,8,0],
        [0,8,0,8,8,8,0,8,0,8,8,8,0,8,0],
        [0,0,0,0,6,0,0,8,0,0,6,0,0,0,0],
        [8,0,8,0,0,0,2,2,2,0,0,0,8,0,8],
        [8,0,8,8,0,8,2,2,2,8,0,8,8,0,8],
        [8,0,8,0,0,0,2,2,2,0,0,0,8,0,8],
        [0,0,0,0,6,0,0,8,0,0,6,0,0,0,0],
        [0,8,0,8,8,8,0,8,0,8,8,8,0,8,0],
        [0,8,0,0,0,8,0,0,0,8,0,0,0,8,0],
        [0,8,8,8,0,8,0,8,0,8,0,8,8,8,0],
        [3,0,0,0,0,0,0,8,0,0,0,0,0,0,3]
      ]
    },
	{ "MAPA_ARCADE": "03",
      "blockers": 90,
      "initial_position_sheep_1": {"x":4, "y":3},
      "initial_position_sheep_2": {"x":10, "y":3},
      "initial_position_sheep_3": {"x":4, "y":9},
      "initial_position_sheep_4": {"x":10, "y":9},
      "sheeps": 4,
      "grid": [
        [3,0,0,1,0,8,0,0,0,8,0,1,0,0,3],
        [0,1,0,0,0,8,0,6,0,8,0,0,0,1,0],
        [0,1,0,1,1,8,0,0,0,8,1,1,0,1,0],
        [0,0,0,0,0,0,0,6,0,0,0,0,0,0,0],
        [0,1,1,1,0,8,8,6,8,8,0,1,1,1,0],
        [0,0,0,0,0,8,2,2,2,8,0,0,0,0,0],
        [8,0,8,8,8,8,2,2,2,8,8,8,8,0,8],
        [0,0,0,0,0,8,2,2,2,8,0,0,0,0,0],
        [0,1,1,1,0,8,8,6,8,8,0,1,1,1,0],
        [0,0,0,0,0,0,0,6,0,0,0,0,0,0,0],
        [0,1,0,1,1,8,0,0,0,8,1,1,0,1,0],
        [0,1,0,0,0,8,0,6,0,8,0,0,0,1,0],
        [3,0,0,1,0,8,0,0,0,8,0,1,0,0,3]
      ]
    }
  ],

  "farm": [

    { "MAPA_ARCADE": "01",
      "blockers": 90,
      "initial_position_sheep_1": {"x":4, "y":4},
      "initial_position_sheep_2": {"x":10, "y":4},
      "initial_position_sheep_3": {"x":4, "y":8},
      "initial_position_sheep_4": {"x":10, "y":8},
      "sheeps": 4,
      "grid": [
        [3,0,0,0,0,0,0,1,0,0,0,0,0,0,3],
        [0,1,1,1,0,1,0,1,0,1,0,1,1,1,0],
        [0,0,0,0,0,1,0,1,0,1,0,0,0,0,0],
        [0,1,1,1,0,1,0,1,0,1,0,1,1,1,0],
        [0,0,0,0,0,0,0,0,0,0,0,0,0,0,0],
        [1,0,1,1,1,0,2,2,2,0,1,1,1,0,1],
        [1,0,0,0,0,0,2,2,2,0,0,0,0,0,1],
        [1,0,1,1,1,0,2,2,2,0,1,1,1,0,1],
        [0,0,0,0,0,0,0,0,0,0,0,0,0,0,0],
        [0,1,1,1,0,1,0,1,0,1,0,1,1,1,0],
        [0,0,0,0,0,1,0,1,0,1,0,0,0,0,0],
        [0,1,1,1,0,1,0,1,0,1,0,1,1,1,0],
        [3,0,0,0,0,0,0,1,0,0,0,0,0,0,3]
      ]
    },
    { "MAPA_ARCADE": "02",
      "blockers": 90,
      "initial_position_sheep_1": {"x":4, "y":3},
      "initial_position_sheep_2": {"x":10, "y":3},
      "initial_position_sheep_3": {"x":4, "y":9},
      "initial_position_sheep_4": {"x":10, "y":9},
      "sheeps": 4,
      "grid": [
        [3,0,0,0,0,0,0,8,0,0,0,0,0,0,3],
        [0,1,0,1,0,1,0,1,0,1,0,1,0,1,0],
        [0,1,0,1,0,1,0,0,0,1,0,1,0,1,0],
        [0,1,0,0,0,0,0,6,0,0,0,0,0,1,0],
        [0,1,0,1,6,8,8,8,8,8,6,1,0,1,0],
        [0,0,0,0,0,8,2,2,2,8,0,0,0,0,0],
        [8,1,1,1,0,8,2,2,2,8,0,1,1,1,8],
        [0,0,0,0,0,8,2,2,2,8,0,0,0,0,0],
        [0,1,0,1,6,8,8,8,8,8,6,1,0,1,0],
        [0,1,0,0,0,0,0,6,0,0,0,0,0,1,0],
        [0,1,0,1,0,1,0,0,0,1,0,1,0,1,0],
        [0,1,0,1,0,1,0,0,0,1,0,1,0,1,0],
        [3,0,0,0,0,0,0,8,0,0,0,0,0,0,3]
      ]
    },
    { "MAPA_ARCADE": "03",
      "blockers": 90,
      "initial_position_sheep_1": {"x":3, "y":2},
      "initial_position_sheep_2": {"x":11, "y":2},
      "initial_position_sheep_3": {"x":3, "y":10},
      "initial_position_sheep_4": {"x":11, "y":10},
      "sheeps": 4,
      "grid": [
        [3,0,0,0,0,0,0,0,0,0,0,0,0,0,3],
        [0,6,8,1,0,1,0,1,0,1,0,1,8,6,0],
        [0,0,0,0,0,0,0,0,0,0,0,0,0,0,0],
        [0,1,0,6,8,1,0,1,0,1,8,6,0,1,0],
        [0,8,5,5,5,5,5,5,5,5,5,5,5,8,0],
        [0,1,5,1,0,8,2,2,2,8,0,1,5,1,0],
        [0,0,5,0,0,8,2,2,2,8,0,0,5,0,0],
        [0,1,5,1,0,8,2,2,2,8,0,1,5,1,0],
        [0,8,5,5,5,5,5,5,5,5,5,5,5,8,0],
        [0,1,0,6,8,1,0,1,0,1,8,6,0,1,0],
        [0,0,0,0,0,0,0,0,0,0,0,0,0,0,0],
        [0,6,8,1,0,1,0,1,0,1,0,1,8,6,0],
        [3,0,0,0,0,0,0,0,0,0,0,0,0,0,3]
      ]
    }
  ]

}