{

  "aqua_park": [

    { "MAPA_ARCADE": "01",
      "blockers": 90,
      "checkpoints_x": [[0, 1], [6, 7], [9, 10], [8, 8]],
      "checkpoints_y": [[2, 2], [10, 10], [4, 4], [0, 1]],
      "grid": [
        [3,3,0,0,0,1,0,0,4,0,0,1,0,0,0],
        [3,3,0,0,0,1,0,0,4,0,0,0,0,1,0],
        [4,4,1,0,0,1,0,0,1,1,1,1,1,1,0],
        [0,0,1,0,0,1,0,0,1,0,0,0,0,8,0],
        [0,0,1,0,0,1,0,0,1,4,4,1,1,1,1],
        [0,0,1,0,0,0,0,0,1,0,0,0,0,0,0],
        [0,0,1,0,0,0,0,0,1,0,0,5,5,1,0],
        [0,0,1,1,1,1,1,1,1,1,1,1,5,1,0],
        [0,0,0,0,8,1,0,0,0,0,0,1,5,1,8],
        [0,2,2,2,0,1,0,0,0,0,0,1,0,1,0],
        [0,2,2,2,0,1,4,4,1,0,0,1,0,1,0],
        [0,2,2,2,0,0,0,0,1,0,0,0,0,1,0],
        [8,0,0,0,0,0,0,0,1,0,0,0,0,0,0]
      ]
    },
    { "MAPA_ARCADE": "02",
      "blockers": 90,
      "checkpoints_x": [[0, 1], [3, 4], [9, 9], [12, 12]],
      "checkpoints_y": [[2, 2], [6, 6], [11, 12], [0, 1]],
      "grid": [
        [3,3,0,0,5,5,5,5,5,5,0,0,4,0,0],
        [3,3,0,0,5,5,5,5,5,5,0,0,4,0,0],
        [4,4,1,1,1,1,1,1,1,1,1,1,1,0,0],
        [0,0,1,0,0,0,0,0,0,0,1,0,1,0,0],
        [0,0,1,0,0,0,0,0,0,0,1,1,1,0,0],
        [0,0,1,0,0,2,2,2,0,0,1,0,0,0,0],
        [0,0,1,4,4,2,2,2,8,8,1,0,0,0,0],
        [0,0,1,0,0,2,2,2,0,0,1,8,8,1,1],
        [0,0,1,0,0,1,0,0,0,0,1,0,0,0,0],
        [0,0,1,0,0,1,0,0,0,0,1,0,0,0,0],
        [8,8,1,0,0,1,0,0,1,1,1,1,1,0,0],
        [0,0,0,0,0,1,0,0,0,4,0,0,0,0,0],
        [0,0,0,0,0,1,0,0,0,4,0,0,0,0,0]
      ]
    },
	{ "MAPA_ARCADE": "03",
      "blockers": 90,
      "checkpoints_x": [[0, 1], [0, 1], [13, 14], [13, 14]],
      "checkpoints_y": [[2, 2], [10, 10], [10, 10], [2, 2]],
      "grid": [
        [3,3,0,0,0,1,1,0,1,1,0,0,0,0,0],
        [3,3,0,0,0,0,1,1,1,0,0,0,0,0,0],
        [4,4,1,1,0,0,0,1,0,0,0,1,1,4,4],
        [0,0,0,1,1,0,0,0,0,0,1,1,0,0,0],
        [1,0,0,0,1,1,0,0,0,1,1,0,0,0,1],
        [1,1,0,0,0,1,2,2,2,1,0,0,0,1,1],
        [0,1,1,8,8,1,2,2,2,1,8,8,1,1,0],
        [1,1,0,0,0,1,2,2,2,1,0,0,0,1,1],
        [1,0,0,0,1,1,0,8,0,1,1,0,0,0,1],
        [0,0,0,1,1,0,0,8,0,0,1,1,0,0,0],
        [4,4,1,1,0,0,0,1,0,0,0,1,1,4,4],
        [0,0,0,0,0,0,1,1,1,0,0,0,0,0,0],
        [0,0,0,0,0,1,1,0,1,1,0,0,0,0,0]
      ]
    }
  ],

  "city": [

    { "MAPA_ARCADE": "01",
      "blockers": 90,
      "checkpoints_x": [[0, 1], [5, 6], [8, 9], [13, 14]],
      "checkpoints_y": [[2, 2], [10, 10], [10, 10], [2, 2]],
      "grid": [
        [3,3,0,0,0,0,0,0,0,0,0,0,0,0,0],
        [3,3,0,0,0,0,0,0,0,0,0,0,0,0,0],
        [4,4,6,9,1,10,9,1,10,9,1,6,9,4,4],
        [0,0,9,9,0,0,0,8,0,0,0,9,9,0,0],
        [0,0,6,9,0,0,0,8,0,0,0,6,9,0,0],
        [0,0,9,9,0,0,2,2,2,0,0,9,9,0,0],
        [0,0,1,1,0,0,2,2,2,0,0,1,1,0,0],
        [0,0,6,9,0,0,2,2,2,0,0,6,9,0,0],
        [0,0,9,9,0,0,0,1,0,0,0,9,9,0,0],
        [0,0,6,9,0,0,0,1,0,0,0,6,9,0,0],
        [8,8,9,9,1,4,4,1,4,4,1,9,9,8,8],
        [0,0,0,0,0,0,0,1,0,0,0,0,0,0,0],
        [0,0,0,0,0,0,0,1,0,0,0,0,0,0,0]
      ]
    },
    { "MAPA_ARCADE": "02",
      "blockers": 90,
      "checkpoints_x": [[0, 1], [3, 3], [13, 14], [12, 12]],
      "checkpoints_y": [[2, 2], [11, 12], [10, 10], [0, 1]],
      "grid": [
        [3,3,0,0,0,8,0,0,0,0,0,0,4,0,0],
        [3,3,0,0,0,8,0,0,0,0,0,0,4,0,0],
        [4,4,2,2,2,6,9,6,9,6,9,6,9,0,0],
        [0,0,2,2,2,9,9,9,9,9,9,9,9,0,0],
        [0,0,2,2,2,1,1,1,1,1,1,6,9,0,0],
        [8,8,1,1,0,0,2,2,2,0,0,9,9,0,0],
        [0,0,0,0,0,0,2,2,2,0,0,0,0,0,0],
        [0,0,6,9,0,0,2,2,2,0,0,1,1,8,8],
        [0,0,9,9,1,1,1,1,1,1,2,2,2,0,0],
        [0,0,6,9,6,9,6,9,6,9,2,2,2,0,0],
        [0,0,9,9,9,9,9,9,9,9,2,2,2,4,4],
        [0,0,4,0,0,0,8,0,0,0,0,0,0,0,0],
        [0,0,4,0,0,0,8,0,0,0,0,0,0,0,0]
      ]
    },
	{ "MAPA_ARCADE": "03",
      "blockers": 90,
      "checkpoints_x": [[0, 1], [6, 6], [11, 11], [8, 8]],
      "checkpoints_y": [[2, 2], [9, 10], [4, 5], [0, 1]],
      "grid": [
        [3,3,0,0,0,0,1,0,4,0,0,0,0,0,0],
        [3,3,0,0,0,0,1,0,4,0,0,0,0,0,0],
        [4,4,1,6,9,0,1,0,1,6,9,6,9,8,8],
        [0,0,1,9,9,0,1,0,1,9,9,9,9,0,0],
        [0,0,0,0,1,0,1,0,1,0,0,4,0,0,0],
        [0,6,9,0,1,0,0,0,1,0,0,4,0,0,0],
        [0,9,9,0,1,2,2,2,1,0,0,1,10,9,1],
        [0,0,0,0,1,2,2,2,6,9,0,0,0,0,0],
        [6,9,0,0,1,2,2,2,9,9,6,9,0,1,0],
        [9,9,8,8,1,0,4,0,0,0,9,9,0,1,0],
        [0,0,0,0,1,0,4,0,0,0,0,0,0,1,0],
        [0,1,10,9,1,0,6,9,0,10,9,1,10,9,0],
        [0,0,0,0,0,0,9,9,0,0,0,0,0,0,8]
      ]
    }
  ],

  "farm": [

    { "MAPA_ARCADE": "01",
      "blockers": 90,
      "checkpoints_x": [[0, 1], [10, 11], [4, 4], [13, 14]],
      "checkpoints_y": [[2, 2], [6, 6], [11, 12], [4, 4]],
      "grid": [
        [3,3,0,0,0,0,0,0,0,0,0,0,0,0,0],
        [3,3,0,0,0,0,0,0,0,0,0,0,0,0,0],
        [4,4,1,2,2,2,1,1,1,1,1,1,1,0,0],
        [0,0,1,2,2,2,1,0,0,0,0,0,1,0,0],
        [0,0,1,2,2,2,1,0,0,0,0,0,1,4,4],
        [0,0,0,0,8,0,0,0,0,1,0,0,1,0,0],
        [0,0,0,0,8,0,0,0,0,1,4,4,1,0,0],
        [1,1,1,1,1,1,1,1,1,1,0,0,1,0,0],
        [0,0,0,0,8,0,0,0,0,0,0,0,1,0,0],
        [0,0,0,0,8,0,0,0,0,0,0,0,1,0,0],
        [0,0,1,1,1,1,1,1,1,1,1,1,1,0,0],
        [0,0,0,0,4,0,0,0,0,0,0,8,0,0,0],
        [0,0,0,0,4,0,0,0,0,0,0,8,0,0,0]
      ]
    },
    { "MAPA_ARCADE": "02",
      "blockers": 90,
      "checkpoints_x": [[0, 1], [9, 9], [3, 4], [13, 14]],
      "checkpoints_y": [[2, 2], [11, 12], [6, 6], [3, 3]],
      "grid": [
        [3,3,0,0,0,0,0,0,0,0,0,0,0,0,0],
        [3,3,0,0,0,0,0,0,0,0,0,0,0,0,0],
        [4,4,1,1,1,1,1,1,1,1,1,1,1,0,0],
        [0,0,1,0,0,0,0,0,0,8,0,0,1,4,4],
        [0,0,1,0,0,0,0,0,0,8,0,0,1,0,0],
        [0,0,1,0,0,1,2,2,2,1,0,0,0,0,0],
        [0,0,1,4,4,1,2,2,2,1,0,0,0,0,0],
        [0,0,1,0,0,1,2,2,2,1,1,1,1,1,1],
        [0,0,1,0,0,0,0,0,0,0,8,0,0,0,0],
        [0,0,1,0,0,0,0,0,0,0,8,0,0,0,0],
        [8,8,1,1,1,1,1,1,1,1,1,1,1,0,0],
        [0,0,0,0,0,0,0,0,0,4,0,0,0,0,0],
        [0,0,0,0,0,0,0,0,0,4,0,0,0,0,0]
      ]
    },
	{ "MAPA_ARCADE": "03",
      "blockers": 90,
      "checkpoints_x": [[0, 1], [3, 4], [10, 10], [13, 14]],
      "checkpoints_y": [[2, 2], [7, 7], [11, 12], [3, 3]],
      "grid": [
        [3,3,0,0,0,0,0,0,0,0,0,0,0,0,0],
        [3,3,0,0,0,0,0,0,0,0,0,0,0,0,0],
        [4,4,1,1,1,1,1,1,1,2,2,2,1,0,0],
        [0,0,1,0,0,0,0,0,1,2,2,2,1,4,4],
        [0,0,1,0,0,0,0,0,1,2,2,2,1,0,0],
        [0,0,1,0,0,1,0,0,1,0,0,0,0,0,0],
        [0,0,1,0,0,1,0,0,1,0,0,0,0,0,0],
        [0,0,1,4,4,1,8,8,1,8,8,1,1,1,1],
        [0,0,1,0,0,1,0,0,1,0,0,0,0,0,0],
        [8,8,1,0,0,1,0,0,1,0,0,0,0,0,0],
        [0,0,1,0,0,1,0,0,1,1,1,1,1,0,0],
        [0,0,0,0,0,1,0,0,0,0,4,0,0,0,0],
        [0,0,0,0,0,1,0,0,0,0,4,0,0,0,0]
      ]
    }
  ],

  "shopping_mall": [

    { "MAPA_ARCADE": "01",
      "blockers": 90,
      "checkpoints_x": [[0, 1], [3, 3], [13, 14], [12, 12]],
      "checkpoints_y": [[2, 2], [11, 12], [10, 10], [0, 1]],
      "grid": [
        [3,3,0,0,0,6,0,0,0,0,0,0,4,0,0],
        [3,3,0,0,0,6,0,0,0,0,0,0,4,0,0],
        [4,4,1,0,0,0,0,0,1,1,1,1,1,0,0],
        [0,0,1,0,0,0,0,0,1,1,0,0,0,0,0],
        [0,0,1,1,1,6,6,6,6,6,0,0,0,0,0],
        [0,0,0,0,0,6,2,2,2,6,8,8,6,6,6],
        [0,0,0,0,0,6,2,2,2,6,0,0,0,0,0],
        [6,6,6,8,8,6,2,2,2,6,0,0,0,0,0],
        [0,0,0,0,0,6,6,6,6,6,1,1,1,0,0],
        [0,0,0,0,0,1,1,0,0,8,0,0,1,0,0],
        [0,0,1,1,1,1,1,0,0,8,0,0,1,4,4],
        [0,0,4,0,0,0,0,0,0,6,0,0,0,0,0],
        [0,0,4,0,0,0,0,0,0,6,0,0,0,0,0]
      ]
    },
    { "MAPA_ARCADE": "02",
      "blockers": 90,
      "checkpoints_x": [[0, 1], [0, 1], [13, 14], [13, 14]],
      "checkpoints_y": [[2, 2], [10, 10], [10, 10], [2, 2]],
      "grid": [
        [3,3,0,0,0,0,0,0,0,0,0,0,0,0,0],
        [3,3,0,0,0,0,0,0,0,0,0,0,0,0,0],
        [4,4,6,6,6,6,6,6,6,6,6,6,6,4,4],
        [0,0,0,0,0,0,1,6,1,0,0,0,0,0,0],
        [0,0,0,0,0,0,1,6,1,0,0,0,0,0,0],
        [1,1,1,1,0,0,2,2,2,0,0,1,1,1,1],
        [6,6,6,6,8,8,2,2,2,8,8,6,6,6,6],
        [1,1,1,1,0,0,2,2,2,0,0,1,1,1,1],
        [0,0,0,0,0,0,1,6,1,0,0,0,0,0,0],
        [0,0,0,0,0,0,1,6,1,0,0,0,0,0,0],
        [4,4,6,6,6,6,6,6,6,6,6,6,6,4,4],
        [0,0,0,0,0,0,0,8,0,0,0,0,0,0,0],
        [0,0,0,0,0,0,0,8,0,0,0,0,0,0,0]
      ]
    },
    { "MAPA_ARCADE": "03",
      "blockers": 90,
      "checkpoints_x": [[0, 1], [4, 4], [13, 14], [10, 10]],
      "checkpoints_y": [[2, 2], [11, 12], [10, 10], [0, 1]],
      "grid": [
        [3,3,0,0,0,0,0,6,0,0,4,0,0,0,0],
        [3,3,0,0,0,0,0,6,0,0,4,0,0,0,0],
        [4,4,1,1,1,0,0,6,0,0,1,1,1,0,0],
        [0,0,1,1,1,0,0,0,0,0,1,1,1,889],
        [0,0,0,0,1,0,0,0,0,0,1,0,0,0,0],
        [0,0,0,0,1,1,2,2,2,1,1,0,0,0,0],
        [6,6,0,0,6,6,2,2,2,6,6,0,0,6,6],
        [0,0,0,0,1,1,2,2,2,1,1,0,0,0,0],
        [0,0,0,0,1,0,0,0,0,0,1,0,0,0,0],
        [8,8,1,1,1,0,0,0,0,0,1,1,1,0,0],
        [0,0,1,1,1,0,0,6,8,8,1,1,1,4,4],
        [0,0,0,0,4,0,0,6,0,0,0,0,0,0,0],
        [0,0,0,0,4,0,0,6,0,0,0,0,0,0,0]
      ]
    }
  ]



}